111111111111111
1P000SS00000001
10000G000000001
10000000G0000E1
111111111111111
