1111111111111111111
1000000000G0000S001
1G00000000000000001
1G000P0000000000001
1S00000000000000001
1000000000S00G00001
1000000000G00G00001
1000000000G00S000E1
1111111111111111111
