1111111111111111111
1000000000G0000S001
1G00000000000000001
1G000P0000000000001
1S000000000000000E1
0000000000S00G00000
