1111111111111111111
100000P000G0000S001
1G0000000000TT00001
1000000S00T000000E1
1111111111111111111
