1111111111111
10GS0000000G1
1000000000001
1P0G0SS000001
1SS0000000001
100ST00000001
100SS000000S1
1000G00000001
1E0000TT00001
1111111111111
