1111111111111111111
100000P000G0000S001
1G0000000000TT00001
1GT00GGG00000000001
1S00000SS0000000001
1000000S00S00G00001
1000000000GT0GT0001
1E00000000G00S00001
1111111111111111111
